0 16 17 18 15 14 14 14 14 14 14 14 14 14 14 13
1 27 17 18 28 19 19 19 19 19 19 19 19 19 19 12
2 29 17 18 30 20 20 20 20 20 20 20 20 20 20 11
3 21 17 18 21 21 21 21 21 21 21 21 21 21 21 9
4 22 17 24 21 22 21 22 21 22 21 22 21 22 21 9
3 21 23 18 22 21 22 21 22 21 22 21 22 21 22 10
4 22 17 24 21 22 21 22 21 22 21 22 21 22 21 9
3 21 23 18 22 21 22 21 22 21 22 21 22 21 22 10
4 22 17 24 21 22 21 22 21 22 21 22 21 22 21 9
3 21 25 26 22 21 22 21 22 21 22 21 22 21 22 10
4 22 21 22 21 22 21 22 21 22 21 22 21 22 21 9
5 6 7 6 7 6 7 6 7 6 7 6 7 6 7 8